##############################
#>  ###############       ####
### ###             ##### ####
### ### ########### ##### ####
### ### ###   #####     #   ##
###     ##### ##### ####### ##
##### ####### ##### ####### ##
##### ####### ##### ####### ##
#####                 ##### ##
########## ##########    ## ##
##########           #####   X
##############################